@..@@@@@@@@@@@..@@@@
@...@@@@@@@@@@..@@@@
@...............@@@@
@@@@..@@@@@@@@..@@@@
@@@@..@@@@@@@@..@@@@
@@@@..@@@@@@@@..@@@@
@@@@..@@@@@@@@..@@@@
@@@@..@@@@@@@@....@@
@@@@..@@@@@@@@@@..@@
@@@@..............@@
@@....@@@@@@@@@@..@@
@@..@@@@@@@@@@@@..@@
@@..@@@@@@@@@@....@@
@@................@@
@@@@@@@@..@@@@@@@@@@
@@@@@@@@..@@@@@@@@@@
@@@@@@@@..@@@@@@@@@@
@@@...............@@
@@@@@@@@@@@@@..@@@@@
@@@@@@@@@@@@@@@@@@@@